1111111111111111111111111111111111
100000P0000CC000000000000000000011
1000000000000000000000000000001E01
1111111111111111111111111111111111