1111111111111111111111111111111111
1000000000000000000000000111000001
100000000000000C000000000101000001
1000000000000000000000000101000001
1000000000000000000000000000000001
1000000000000000000000000000000001
10000000000000C0000000000000000001
1000000000000000000000000000000001
1000000000000000000000000000000001
1000000000000000000000000000000001
10000000000C0000000000000000000001
1000000000000000000000000000000001
1000000000000000000000000000000001
10∆0000000000000000000000000000001
10000000000000000000000000000C0001
1000000000000000000000000000010001
10000000000000000000000000P0000E01
1111111111111111111111111111111111